#########################
#.#.....................#
#.#.#...................#
#.#####.................#
#..............###......#
#................########
#.#######################
#.......................#
############..###########
#############.###.......#
#...........#.....#####.#
#########...####..#...#.#
#...........##....#.#.#.#
#...........#.....#.#...#
#...........#######.#####
#.......................#
#......#................#
#......#................#
#...#############.......#
#....#.#.....#..........#
#....#.#.....#..........#
#..###..................#
#..#....................#
#.......................#
#########################