###############
#.....<.....#f#
#D#########.#d#
#.#..>Ly.I#d#.#
#d#D#d#####.#D#
#.#.#wRBbo#D#.#
#D#d#######.#d#
#.#...<.....#.#
#d###########D#
#.....<.......#
###############

###############
#i#...>.......#
#d#D#########d#
#.#>#B.....<#>#
#D#d#D###d###D#
#...#bOB#.....#
#######d#######
#b.<.......>.B#
#D###########d#
#F#         #W#
###         ###