#########################
#.#.....................#
#.#w#...................#
#.#####.................#
#..............###......#
#................########
#.#######################
#.......................#
############..###.......#
#############.###.#######
            #.....#
################..#######
#######...........#...#.#
#...###..####.....#.#...#
###.####..#.#######.#####
#.......................#
#......#................#
#......#................#
#...#############.......#
#....#f#.....#..........#
#....#.#.....#..........#
#..###..................#
#..#....................#
#.......................#
#########################