###########
#F.......W#
#...L.R...#
#...L.R...#
#.........#
#...f.w...#
#.........#
#...AAA...#
#.........#
#<.......>#
###########