#####
#f.w#
#...#
#LAR#
#<A>#
#LAR#
#...#
#.AA#
#...#
#AA.#
#...#
#.AA#
#...#
#AA.#
#...#
#LAR#
#FAW#
#>A<#
#...#
#####
