#############
#f.........w#
#.#d#...###.#
#.#<##.##>#.#
#.#>#b.y#<#.#
#.#i##.##o#.#
#.###...###.#
#F.........W#
#############