###################
#<#...#...#...#..>#
#.###.#.#.#.#.###.#
#.....#>#...#<#...#
#.###.###.#.###.###
#.#.#.....#.......#
#.#.###.#####.#####
#.#.#...#.....#F<.#
#f#.#####.#.#####w#
#.#.......#...#.#.#
#>#.#.#####.###.#.#
#W#.#...#...#.....#
#####.#.###.###.###
#.....#.#...#.....#
###.#####.#####.#.#
#...#.........#.#.#
#.#.###.#####.#.###
#<#..>#....<#....>#
###################