       #######
#####  #<><><#
#wRW#  #><><>#
#AiA#  #<>I><#
#FLf#  #><><>#
#####  #<><><#
       #######

  ###########
  #o..B.b..O#
  ##d#####D##
  #LLLAAARRR#
  ###d###D###
  #LLLLARRRR#
  ####d#D####
  #LLLLARRRR#
  ####D#d####
  #LLLLARRRR#
  ###D###d###
  #LLLAAARRR#
  ##D#####d##
  #y.......Y#
  ###########