###########
#.........#
#.###.###.#
#.#F#.#W#.#
#.........#
#..f...w..#
#.........#
#.<#<.>#>.#
#.###.###.#
#.<#<.>#>.#
#.........#
###########