###############
#AAAL<#F#LLLLL#
#A<LLA#f#LAAAL#
#ALL<A#.#LA<AL#
#LL<AA#.#LALAL#
#LAAAA#.#LLLAL#
#d#####.#####D#
#.....b.B.....#
#d#####.#####D#
#RARRR#.#AAAAR#
#RARAR#.#AA>RR#
#RA>AR#.#A>RRA#
#RAAAR#w#ARR>A#
#RRRRR#W#>RAAA#
###############