###############
#.....<.....#f#
#D#########.#d#
#.#...>yLI#d#.#
#d#D#d#####.#D#
#.#.#wbBRo#D#.#
#D#d#######.#d#
#.#...<.....#.#
#d###########D#
#.....<.......#
###############

###############
#i#...>.......#
#d#D#########d#
#.#>#B.....<#>#
#D#d#D###d###D#
#...#bBO#.....#
#######d#######
#b.<.......>.B#
#D###########d#
#F#         #W#
###         ###